16
16
1111111111111111
1111111111111111
1111111111111111
1111111111111111
1111000000001111
1111000000001111
1111002002001111
1111000000001111
1111000000001111
1111000000001111
1111111011111111
1111000000001111
1111111111111111
1111111111111111
1111111111111111
1111111111111111