30
25
1111111111111111111111111
1111111111000066611000011
1111111100000006660000001
1111111100000006660000001
1111111000000006600000001
1111110000000006660000001
1111110000000000611000011
1111110000000000111111111
1111100000000000011111111
1111110000000000011111111
1111111000000000001111111
1111111100000000001111111
1111111110000000000111111
1111111110000000000111111
1100001000000000011111111
1000001100000000011110011
1000000110000000011100011
1000000110000000011000001
1100000010000000111000011
1110000110000001110000011
1111000100000001110000011
1111100000000000000000111
1111100000000000000001111
1111110000000000111111111
1111111000000011111111111
1111111000000011111111111
1111111000000011111111111
1111111000000011111111111
1111111000000111111111111
1111111100001111111111111