20
32
55555555555555555555555555555555
55559999999999999999999999995555
55559999999999999999999999995555
55559988888888888888888888995555
55559983333333333333333338995555
55559983333333333333333338995555
55559983333333333333333338995555
55559983333333333333333338995555
55559983333333333333333338995555
55559983333333333333333338995555
55559983333333333333333333995555
55559983333333333333333338995555
55559983333333333333333338995555
55559983333333333333333338995555
55559983333333333333333338995555
55559983333333333333333338995555
55559988888888888888888888995555
55559999999999999999999999995555
55559999999999999999999999995555
55555555555555555555555555555555