20
21
111111111111111111111
111000000000000001111
110000000000000000111
100000002002000000011
100000000000000000011
100000000000000000011
100000000000000000011
100000000000000000011
100000000000000000011
100000000000000000011
100000000000000000011
100000000000000000011
100000000000000000011
111111111001111111111
111111111001111111111
111111110000111111111
111111100000011111111
100000000000000000011
100000000000000000011
111111111111111111111
111111111111111111111