20
20
77777777733777777777
73333333333333333337
73333333333333333337
73313131333333333337
73333333333333333337
73313131333333333337
73333333333333333337
73333333333331313137
73333333333333333337
73333333333331313137
73333333333333333337
73313131333333333337
73333333333333333337
73333333333333333337
73313131333333333337
73333333333337777777
73333333333337333337
73333333333333333337
73333333333337333337
77777777733777777777